NO ./textures/AnyConv.com__brick-texture-png-23868.xpm
SO ./textures/AnyConv.com__brick-texture-png-23873.xpm
WE ./textures/AnyConv.com__brick-texture-png-23885.xpm
EA ./textures/AnyConv.com__brick-texture-png-23887.xpm

C 115,215,225
F 200,233,233

        1111111111111111111111111
        1000000000110000000000001
        1011000001110000000000001
        1001000000000000000000001
111111111011000001110000000000001
100000000011000001110111111111111
11110111111111011100000010001
11113111111111S11101010010001
11000000110101011100000030001
10000000000040001100000010001
10000000000000001101010010001
110000011101010111110111100111
11110111 1110101 101111010001
11111111 1111111 111111111111
