NO ./textures/AnyConv.com__brick-texture-png-23868.xpm
SO ./textures/AnyConv.com__brick-texture-png-23873.xpm
WE ./textures/AnyConv.com__brick-texture-png-23885.xpm
EA ./textures/AnyConv.com__brick-texture-png-23887.xpm

C 115,215,225
F 74,160,44

111111111111111111111111111111111111111111111111111111111111111111111111111111111111111111111
1S1000000000000000000000000000000000000000000000000000000000000000000000000000000000000000001
101000000000000000000000000000000000000000000000000000000000000000000000000000000000000000001
100000000000000000000000000000000000000000000000000000000000000000000000000000000000000000001
100000000000000000000000000000000000000000000000000000000000000000000000000000000000000000001
100000000000000000000000000000000000000000000000000000000000000000000000000000000000000000001
100000000000000000000000000000000000000000000000000000000000000000000000000000000000000000001
100000000000000000000000000000000000000000000000000000000000000000000000000000000000000000001
100000000000000000000000000000000000000000000000000000000000000000000000000000000000000000001
100000000000000000000000000000000000000000000000000000000000000000000000000000000000000000001
100000000010101010101010101010101010101010101010101010101010101010101010101010101010000000001
100000000000000000000000000000000000000000000000000000000000000000000000000000000000000000001
100000000010101010101010101010101010101010101010101010101010101010101010101010101010000000001
100000000000000000000000000000000000000000000000000000000000000000000000000000000000000000001
100000000010101010101010101010101010101010101010101010101010101010101010101010101010000000001
100000000000000000000000000000000000000000000000000000000000000000000000000000000000000000001
100000000010101010101010101010101010101010101010101010101010101010101010101010101010000000001
100000000000000000000000000000000000000000000000000000000000000000000000000000000000000000001
100000000010101010101010101010101010101010101010101010101010101010101010101010101010000000001
100000000000000000000000000000000000000000000000000000000000000000000000000000000000000000001
100000000010101010101010101010101010101010101010101010101010101010101010101010101010000000001
100000000000000000000000000000000000000000000000000000000000000000000000000000000000000000001
100000000010101010101010101010101010101010101010101010101010101010101010101010101010000000001
100000000000000000000000000000000000000000000000000000000000000000000000000000000000000000001
100000000010101010101010101010101010101010101010101010101010101010101010101010101010000000001
100000000000000000000000000000000000000000000000000000000000000000000000000000000000000000001
100000000010101010101010101010101010101010101010101010101010101010101010101010101010000000001
100000000000000000000000000000000000000000000000000000000000000000000000000000000000000000001
100000000010101010101010101010101010101010101010101010101010101010101010101010101010000000001
100000000000000000000000000000000000000000000000000000000000000000000000000000000000000000001
100000000010101010101010101010101010101010101010101010101010101010101010101010101010000000001
100000000000000000000000000000000000000000000000000000000000000000000000000000000000000000001
100000000010101010101010101010101010101010101010101010101010101010101010101010101010000000001
100000000000000000000000000000000000000000000000000000000000000000000000000000000000000000001
100000000010101010101010101010101010101010101010101010101010101010101010101010101010000000001
100000000000000000000000000000000000000000000000000000000000000000000000000000000000000000001
100000000010101010101010101010101010101010101010101010101010101010101010101010101010000000001
100000000000000000000000000000000000000000000000000000000000000000000000000000000000000000001
100000000010101010101010101010101010101010101010101010101010101010101010101010101010000000001
100000000000000000000000000000000000000000000000000000000000000000000000000000000000000000001
100000000010101010101010101010101010101010101010101010101010101010101010101010101010000000001
100000000000000000000000000000000000000000000000000000000000000000000000000000000000000000001
100000000010101010101010101010101010101010101010101010101010101010101010101010101010000000001
100000000000000000000000000000000000000000000000000000000000000000000000000000000000000000001
100000000010101010101010101010101010101010101010101010101010101010101010101010101010000000001
100000000000000000000000000000000000000000000000000000000000000000000000000000000000000000001
100000000010101010101010101010101010101010101010101010101010101010101010101010101010000000001
100000000000000000000000000000000000000000000000000000000000000000000000000000000000000000001
100000000010101010101010101010101010101010101010101010101010101010101010101010101010000000001
100000000000000000000000000000000000000000000000000000000000000000000000000000000000000000001
100000000010101010101010101010101010101010101010101010101010101010101010101010101010000000001
100000000000000000000000000000000000000000000000000000000000000000000000000000000000000000001
100000000000000000000000000000000000000000000000000000000000000000000000000000000000000000001
100000000000000000000000000000000000000000000000000000000000000000000000000000000000000000001
100000000000000000000000000000000000000000000000000000000000000000000000000000000000000000001
100000000000000000000000000000000000000000000000000000000000000000000000000000000000000000001
100000000000000000000000000000000000000000000000000000000000000000000000000000000000000000001
100000000000000000000000000000000000000000000000000000000000000000000000000000000000000000001
100000000000000000000000000000000000000000000000000000000000000000000000000000000000000000001
100000000000000000000000000000000000000000000000000000000000000000000000000000000000000000001
100000000000000000000000000000000000000000000000000000000000000000000000000000000000000000001
111111111111111111111111111111111111111111111111111111111111111111111111111111111111111111111
